WWWWWWWWWWWWWWWWWWWWWWW.TTT..^^^^...WWWWWWWWNone
WWWWWWWWWWWWWWWWWWWWWW...T..^^^^....WWWWWWWWNone
WWWWWWWWWWWWWWWWWWWWWW......^^^......WWWWWWWNone
WWWWWWWWWWWWWWWWWWWWW..T.....^^^^..T.WWWWWWWNone
WWWWWWWWWWWWWWWWWWWWW........^^^^..T.WWWWWWWNone
WWWWWWWWWWWWWWWWWWWW........^^^....T.WWWWWWWNone
WWWWWWWWWWWWWWWWWWWW........^^^......WWWWWWWNone
WWWWWWWWWWWWWWWWWWWWWW.....^^^^.....WWWWWWWWNone
WWWWWWWWWWWWWWWWWWWWWW.....^^^......WWWWWWWWNone
WWWWWWWWWWWWWWWWWWWWWWW....^^......WWWWWWWWWNone
WWWWWWWWWWWWWWWWWWWWWW......^.....WWWWWWWWWWNone
WWWWWWWWWWWWWWWWWWWWW............WWWWWWWWWWWNone
WWWWWWWWWWWWWWWWWWWW....T......WWWWWWWWWWWWWNone
WWWWW...WWWWWWWWWWWWW..T.T.....WWWWWWWWWWWWWNone
WWWW..TTT.WWWWWWWWWWW...T.....WWWWWWWWWWWWWWNone
WWWWW.......WWWWWWWWWWW......WWWWWWWWWWWWWWWNone
WWWWWWWW...T.WWWWWWWWWWWWWWWWWWWWWWWWWWWWWWWNone
WWWWWWWWW....WWWWWWWWWWWWWWWWWWWWWWWWWWWWWWWNone
WWWWWWWWWW.T.WWWWWWWWWWWWWWWWWWWWWWWWWWWWWWWNone
WWWWWWWWWWW.WWWWWWWWWW.....WWWWWWWWWWWWWWWWWNone
WWWWWWWWWWWWWWWWWWWWW....T..WWWWWWWWWWWWWWWWNone
WWWWWWWWWWWWWWWWWWWWWWW.TTT..WWWWWWWWWWWWWWWNone
WWWWWWWWWWWWWWWWWWWWWWW..T..WWWWWWWWWWWWWWWWNone
WWWWWWWWWWWWWWWWWWWWWW...WWWWWWWWWWWWWWWWWWWNone
WWWWWWWWWWWWWWWWWWWWWWWWWWWWWWWWWWWWWWWWWWWWNone
WWWWWWWWWWWWWWWWWWWWWWWWWWWWWWWWWWWWWWWWWWWWNone
WWWWWWWWWWWWWWWWWWWWWWWWWWWWWWWWWWWWWWWWWWWWNone
W: WNoneTENone                                    None
T: TNoneEE                                     None
.: NoneNoneNoneNoneNone                                    None
^: MNoneNoneNoneTNoneNoneNone                                 None
